NO assets/Pableada.png
SO assets/puchaina.png
WE assets/luffy.png
EA assets/zoro.png

F 84,59,14
C 0,156,221


         11111111111111
    1111110000000000001
    10000000000000000111
    11111111111111100001
                  111111

111111111111111111111111
111111111111000000000001
100000000000000000000001
1000000000000S1000000011
10000000000001000000011
1000000000000000000111
11111111000000000111
       11111111111