NO assets/Pableada.png
SO assets/puchaina.png
WE assets/luffy.png
EA assets/zoro.png

F 84,59,14
C 0,156,221


    1111111111111111111111111
    1000000000110000000000001
    1011000001110000000000001
    10010000000000000000000011111
111111111011000001110000000000001
100000000011000001110111111111111
11110111111111011100000010001
11110111111111011101010010001
11001000110101011100000010001
100000001000000011000S0010001
10000000000000001101010010001
1110100111010101111101111010111
11100111 1110101 101111010001
11111111 1111111 111111111111